000000000
100000001
110000001
110000001
110000001
000000000
000000000
000000000
111101111
111101111
100000001
100000001
100000001
111111111